1111111111
10E000X001
1000000011
100X000CP1
100C000011
1010010011
1111111111