1111111111
10E000X001
1000000011
100X000CP1
1111111111