1111111111
10E0000001
1000000011
1000000CP1
1111111111