1111111111
10E0000001
1000000011
10P0000C01
1111111111