111111111111111111111111111
10E000X00100100X00C1C000X01
11111101111010011111000C001
100000XC0000X000C0000X000C1
100000000100C01001100C01001
1P10010X00010010011010X10C1
11111101111010011111000C001
100X000C0000X000C0000X000C1
100000000100C01001100C01001
11111101111010011111000C001
100X000C0000X000C0000X000C1
10000X000100C01101100C01001
1100000C0100X000C00000000C1
1C000X000100C01001100C010X1
110000000000001000000000001
111111111111111111111111111