11111111111111111111111111
1C0000000000000000000000E1
11111101111111111111110111
11C000000000000000C0000001
10111111111111111111101101
1P0000000000000000000000X1
11111111111111111111111111
