11111111111111111111111111
10E0000001X0100000C1C00001
11111101111010000000000C01
1P00000C00000000C000000101
100000X00000000000000001X1
11111111111111111111111111
